55505550555
44404440444
33303330333
22222222222
11101110111
11101110111