0000000000
5555555555
4444444444
3333333333
2222222222
1111111111